1111111111
10P000C001
1000010C01
1000111E01
1111111111