11111111111111111111111
11P11C011C0000000000011
110000000011C0000000011
11000000000000C00000011
1100000000000110011C011
1100000000000C000000011
11000111111110000000011
11000000000000C00000011
1100000000000110011C011
11000C000000C000000E011
11111111111111111111111