11111111111111
11P00000000011
11C0011C110011
11000C00000011
11C0011C110011
11000C00000E11
11111111111111