11111111111111
10000000000P01
10C0000C000001
10000C00000001
10C0000C000001
10000C00000E01
11111111111111