111111111111
1CCCCCCCCCC1
1CCCCPCCCCC1
1CCCCCCCCC11
1CCCCCCCCEC1
111111111111