1111111111
1P01C10001
10001000E1
1111111111