111111111111
1CCCCCCCCCC1
1CCCCPCCCCC1
1CCCCCCCCCC1
1CCCCCECCCC1
111111111111