111111111111111111111111111
11P011000C00000011000001C11
110011000000011000000000011
1100000001110000111C0000E11
110011000000001100000000011
11110000C000000110000000C11
111111111111111111111111111